18
9
0 0 0 0 0 0 0 0 0 0 0 0 0 0 0 0 0 0
0 0 0 0 0 0 0 0 0 0 0 0 0 0 0 0 0 0
0 0 0 0 0 0 0 0 0 0 0 0 0 0 0 0 0 0
0 0 0 0 0 0 0 0 0 0 0 0 0 0 0 0 0 0
26 0 0 0 0 0 0 0 0 0 0 0 0 0 0 0 0 0
26 0 0 0 0 0 0 0 0 0 0 0 0 0 0 0 22 26
26 0 0 22 0 23 24 25 0 0 0 0 0 0 0 0 22 26
26 0 21 0 0 0 0 0 0 0 0 0 0 0 0 0 22 26
21 21 21 21 21 21 21 21 21 21 21 21 21 21 21 21 21 21